1111111111111
1001000P000C1
1000011111001
10P011000E001
1111111111111
