1111111111111
1001000E000C1
1000011111001
10P011000E001
1111111111111
